1111111111
11110010P1
111E010C01
1111111111
