1111111111111111111111111111111
10000000C00000000C0000000000011
11111C0111111000011111100011111
1111111111000001111111111111111
110000C00000C000C0000CC00011111
111110000P000000E0000C000011111
1111111111111111111111111111111