11111111111111
100010000C0001
1000C001110C01
10P00011E00001
11111111111111